R 400 500
NO ./images/sever_gora.xpm
SO ./images/gori_sochi.xpm
WE ./images/zapad.xpm
EA ./images/vostok.xpm
S ./images/sprite2.xpm
F 255, 43, 54
C 255, 255, 0

        1111111111111111111111111
        1000000000110000000000001
        1011000001110000000000001
        1001000000000000000000001
111111111011000001110000000000001
100000000011000001110111111111111
11110111111111011100000010001
11110111111111011101010010001
11000000110101011100000010001
10000000000000001100000010001
10000000000000201101010010001
110000011101010111110111100111
1111N111 1110101 101111010001
11111111 1111111 111111111111
