R 600 400

NO ./images/sever_gora.xpm
SO ./images/gori_sochi.xpm
WE ./images/zapad.xpm
EA ./images/vostok.xpm
S ./images/sprite2.xpm

F 0 ,0 , 0
C 255, 255, 0

1111111111111
1000000000001
1000000000001
1000000000001
1002000000001
1000000000011
1222020W00001
1111111111111
