R 1920 1080

NO ./images/sever_gora.xpm
SO ./images/gori_sochi.xpm
WE ./images/zapad.xpm
EA ./images/vostok.xpm
S ./path_to_the_sprite_texture

F 0 ,0 , 0
C 255, 255, 0

1111111111111
1000000000001
100000000N001
1000000000001
1000000000001
1100000000001
1000200000001
1111111111111
