R 900 900
NO ./images/sever_gora.xpm
SO ./images/gori_sochi.xpm
WE ./images/zapad.xpm
EA ./images/vostok.xpm
S ./images/sprite2.xpm
F 0, 255, 255
C 255, 0, 0

        1111111111111111111111111
        1000000000110000000000001
        1011000001110000000000001
        1001000000000000000000001
111111111011000001110000000000001
100000000011010101110111111111111
11110111111111011100000010001
11110111111111011101010010001
11002000110101011100000010001
10000000000000001100000010001
1000S000000000201101010010001
110000011101010111110111100111
11110111 1110101 101111010001
11111111 1111111 111111111111
